眼镜蛇戴眼镜	F
鲸鱼是鱼	F
人有32颗牙齿	F
《水浒》的作者是吴承恩	F
人进入死海会淹死	F
世界杯冠军奖杯是国际足联世界杯	T
成都市花是莲花	F
我国公安机关是行政机关	T
《本草纲目》的作者是神农	F
昙花只在晚上开	T
金庸籍贯是台湾	F
地球有46亿年的历史	T
“沙龙”源于英国	F
“普洱茶”源于地名	T
狗的世界是黑白的	T
篮球起源于美国	T
滑冰最初是交通工具的	T
海南岛是我国第一大岛	T
老舍原名舍予	F
大象不会跳	T
纸不能对折超过7次	F
猪不能仰头	T
长颈鹿不会咳嗽	T
猫头鹰只能看到黑白色	F
人不能舔到自己所有的牙齿	F
干冰是冰	F
水银不是银	T
麦当娜是麦当劳的姐姐	F
奥迪是奥拓的表哥	F
番茄酱曾经是药品	T
巧克力对狗是致命的	T
蟑螂没头也能活	T
男性较女性视力好	T
鳄鱼不能伸舌头	T
北极熊是左撇子	T
鸭子有两只脚	T
母鸡不会叫	F
猫是色盲	T
海马属于马	F
海马是游得最慢的鱼	T
地球两极没有地震	T
藏族人没有姓	T
人憋气不会死	T
熊是左撇子	T
珍珠会溶于醋	T
鸭子的叫声没有回音	T
西瓜都是圆的	F
大象死的时候会倒下	F
河马跑得比人快	T
人的两个肺一样大	F
O型血是最常见的血型	T
人耳一直在生长	T
人的肝脏有500百多种功能	T
人体最有力的肌肉是舌头	T
吃太饱听力会变差	T
人类每星期长出一层新皮肤	F
人舔不到自己的手肘	T
人最敏感的手指是小拇指	F
三原色是红绿黄	F
岁寒三友指梅兰竹	F
我国第一位女词人是李清照	T
榜眼是第三名	F
膝盖不弯跳不起来	T
灯泡塞到嘴里会拿不出来	T
金鱼健忘	T
果丹皮的原料是山楂	F
鱼香肉丝是用鱼做的	F
三姑六婆的三姑是指三个姑姑	F
冷藏后的橡皮筋更易断	F
红色和蓝色相混是绿色	F
巧克力可防心脏病	T
啤酒不能用塑料瓶子装	T